R 1000 800
NO ./ballons.xpm
SO ./ballons.xpm
WE ./ballons.xpm
EA ./ballons.xpm
S  ./ballons.xpm

C 230,255,255
F 0,0,0
                   1111111
                  110000011
                 10000000001
        11111111110000000001111111111
        11000000110000000001100000011
        10000000110000000001100000001
        10000000110000000001100000001
        10000000000000000000000000001
        10000000000000000000000000001
        10000000000000000000000000001
        10000000000000000000000000001
1111111111111111111000000011111111111111111111
1000000001111111111000000011111111110000000001
1000000000000000000000000000000000000000000001
1000000000000000000000N00000000000000000000001
1000000000000000000000000000000000000000000001
1000000001111111111000000011111111110000000001
1111111111111111111000000011111111111111111111
        10000000000000000000000000001
        10000000000000000000000000001
        10000000000000000000000000001
        10000000000000000000000000001
        10000000110000000001100000001
        10000000110000000001100000001
        11000000110000000001100000011
        11111111110000000001111111111
                 10000000001
                  110000011
                   1111111
