R 1200 800
NO texture/fire_b_r.xpm
SO texture/fire_b_r1.xpm
WE texture/fire_b_r2.xpm
EA texture/fire_b_r3.xpm
S  texture/ballons.xpm

C 200,100,100
F 30,0,0

111111111111111111111111111111111111111111111111           111111
100000000000000000000000000000000000000000000001         11000001
100000000000000000000000000000000000000000000001      11110000001
100000000000000000000000000000000000000000000001     100000000001
111111111111111111111111111111111111111111100001    1000000000001
                                          100001   10000000000001
                                          100001  100000000000001
                                          100001  111111111100001
                                          100001           100001
                                          100001           100001
                                          100001           100001
                                          100001           100001
                                          100001           100001
                                          100001           100001
111111111111111111111111111111111111111111100001           100001
100000000000000000000000000000000000000000000001           100001
100000000000000000000000000000000000000000000001           100001
100000000000000000000000000000000000000000000001           100001
100001111111111111111111111111111111111111111111           100001
100001                                                     100001
100001                                                     100001
100001                                                     100001
100001                                                     100001
100001                                                     100001
100001                                                     100001
100001                                                     100001
100001                                                     100001
100001                                                     100N01
10000111111111111111111111111111111111111111111111111111111100001
10000000000000000000000000000000000000000000000000000000000000001
10000000000000000000000000000000000000000000000000000000000000001
10000000000000000000000000000000000000000000000000000000000000001
11111111111111111111111111111111111111111111111111111111111111111
