R 1200 800
NO ./ballons.xpm
SO ./ballons.xpm
WE ./ballons.xpm
EA ./ballons.xpm
S  ./ballons.xpm

C 0,255,255
F 0,255,0

1111111111111111111111111111
1111111111111111111111111111
1100000000000000000000000011
1100000000000000000000000011
1100000000000000000000000011
1100000000000000000000000011
1100000000000000000000000011
1100000000000N00000000000011
1100000000000000000000000011
1100000000000000000000000011
1100000000000000000000000011
1100000000000000000000000011
1100000000000000000000000011
1111111111111111111111111111
1111111111111111111111111111
