R 1000 800
NO texture/fire_b_r.xpm
SO texture/fire_b_r1.xpm
WE texture/fire_b_r2.xpm
EA texture/fire_b_r3.xpm
S  texture/ballons.xpm

C 200,100,100
F 30,0,0
                  111111111
                 11100000111
                 10000000001
        11111111110200000001111111111
        11000000110000000001100000011
        10000000110000000001100000001
        10000002110000000001120000001
        10000000000000020000000000001
        10000000000000000000000000001
        10000000000000000000000000001
        10000000002000000000000000001
1111111111111111111000000011111111111111111111
1000000001111111111000000011111111110000000001
1000000000000000000000000000000000000000000001
1000000000000000000000N00000000000000000000001
1000000000000000000000000000000000000000000001
1000000001111111111000000011111111110000000001
1111111111111111111000000011111111111111111111
        10000000000000000000000000001
        10000000000000000000000000001
        10000000000000000000000000001
        10000000000000000000000000001
        10000000110000000001100000001
        10000000110000000001100000001
        11000000110000000001100000011
        11111111110000000001111111111
                 10000000001
                 11100000111
                  111111111
