R 800 600
NO texture/ballons.xpm
SO texture/fire_b_r1.xpm
WE texture/fire_b_r2.xpm
EA texture/fire_b_r3.xpm
S  texture/ballons.xpm

C 200,100,100
F 30,0,0

111111111
100020001
100000001
120000021
100000001
1000N0001
100000001
111111111
