R  1920 999
NO ./ballons.xpm
SO ./ballons.xpm
WE ./ballons.xpm
EA ./ballons.xpm
S  ./ballons.xpm

C 1, 1, 1
F 1, 1, 1


        1111111111111111011111111
        1000000000110000000000001
        1011000001110000002000001
        1001000000000000000000001
111111111011000001110000000000001
100000000011000001110111111111111
11110111111111011100000010001
11110111111111011101010010001
11000000110101011100000010001
10002000000000001100000010001
10000000000000001101010010001
11000001111101011111011110N0111
11110111 1110101 101111010001
11111111 1111111 1111111111111
