R 1000 1000
NO ./ballons.xpm
SO ./ballons.xpm
WE ./ballons.xpm
EA ./ballons.xpm
S  ./ballons.xpm

C 1, 1, 1
F 1, 1, 1


        1111111111111111111111111
        1000000000110000000000001
        1011000001110000002000001
        1000000000110000000N00001
        1011000001110020002000001
        1000000000110000000000001
        1011000001110000002000001
        1001000000000000000000001
111111111011000001110000000000001
100000000011000001110111111111111
11110111111111011100000010001
11110111111111011101010010001
11000000110101011100000010001
10002000000000001100000010001
10000000000000001101010010001
11000001111101000000011110011
11110001111110001111101000001
   100011   1110101 1011110011111111111
   100011   1000001 1000000000000000001
   100011   1000001 1000001000000000101
   100011   1000001 1000001000000000101
   100011   100000111000011111111111101
   100011   100000000000000010000001001
   100011   100000111000000010000001001
   100011   1000001 1000000000000001001
   111111   1111111 1111111111111111111
