R  1503 1000
NO texture/fire2.xpm
SO texture/fire3.xpm
WE texture/fire4.xpm
EA texture/fire1.xpm
S  texture/portal.xpm

C 228,150,131
F 80,20,20
                  111111111
                 11122222111
                 10020000001
        11111111110200000001111111111
        11000001111000002011110002011
        10200000110020000001100200001
        11000001111100000111110002011
        10000200000000020000002000001
        10020000000020000000000200001
        10000002000000000200000000001
        10000000001000000010000200021
1111111111111111111000000011111111111111111111
1200000001111111111200000211111111110000000021
1200000000000000001000000010000000002000000021
1200020000000000000000N00000000002000000000021
1200000020000020001000000012000000000002000021
1200000001111111111200000211111111112000000021
1111111111111111111000000011111111111111111111
        10000000001000000010000000001
        10000000200000000000200000001
        10000000000002000000000200001
        10002000000000000000000000001
        11000001111100000111110000011
        10000000110000000001100002001
        11020000110000002001102000011
        11111111110000000001111111111
                 10002000001
                 11122222111
                  111111111
