R 1200 800
NO texture/fire_b_r.xpm
SO texture/fire_b_r1.xpm
WE texture/fire_b_r2.xpm
EA texture/fire_b_r3.xpm
S  texture/ballons.xpm

C 200,100,100
F 30,0,0

                                                                1
                                                               11
                                                              111
                                                             1101
                                                            11001
                                                           110001
111111111111111111111111111111111111111111111111          1100001
100000000000000000000000000000000000000000000001         11000001
100000000000000000000000000000000000000000000001        110000001
100000000000000000000000000000000000000000000001       1100000001
111111111111111111111111111111111111111111100001      11000000001
                                          100001     110000000001
                                          100001    1100000000001
                                          100001   11000000000001
                                          100001  110000000000001
                                          100001 1000000000000001
                                          10000110000000000000001
                                          10000000000000000000001
                                          10000111111111111100001
                                          100001           100001
111111111111111111111111111111111111111111100001           100001
100000000000000000000000000000000000000000000001           100001
100000000000000000000000000000000000000000000001           100001
100000000000000000000000000000000000000000000001           100001
100001111111111111111111111111111111111111111111           100001
100001                                                     100001
100001                                                     100001
100001                                                     100001
100001                                                     100001
100001                                                     100001
100001                                                     100001
100001                                                     100001
100001                                                     100001
100001                                                     100N01
10000111111111111111111111111111111111111111111111111111111100001
10000000000000000000000000000000000000000000000000000000000000001
10000000000000000000000000000000000000000000000000000000000000001
10000000000000000000000000000000000000000000000000000000000000001
11111111111111111111111111111111111111111111111111111111111111111
