R  1503 1000
NO texture/sky_stars5.xpm
SO texture/fire_b_r.xpm
WE texture/fire_b_r2.xpm
EA texture/fire_b_r3.xpm
S  texture/sprite2.xpm

C 80,70,190
F 20,0,0
                  111111111
                 11100000111
                 10020000001
        11111111110200000001111111111
        11000000110000002001100002011
        10200000110020000001100200001
        10000002110000000001120002001
        10000200000000020000002000001
        10020000000020000000000200001
        10000002000000000200000000001
        10000000002000000000000200001
1111111111111111111002000011111111111111111111
1000000001111111111000000011111111110000000001
1000000000000000000000000200000000002000000001
1000020000000000000000N00000000002000000000001
1200000020000020000000000002000000000002000001
1000000001111111111000000011111111110000000001
1111111111111111111000000011111111111111111111
        10000000000000000000000000001
        10000000200000000000200000001
        10000000000002000000000200001
        10002000000000000000000000001
        10000000112000000001100000001
        10000000110000000001100000001
        11000000110000002001100000011
        11111111110000000001111111111
                 10002000001
                 11100000111
                  111111111
