R 1200 99999999
NO texture/sprite2.xpm
SO texture/sprite2.xpm
WE texture/sprite2.xpm
EA texture/sprite2.xpm
S  texture/sprite2.xpm

C 200,100,100
F 30,0,0

111111111
100000001
100000001
1000000011111111111111111
1000000000000000000000001
1000N00011111111111111111
100000001
111111111
