R  1500 1000
NO texture/room2.xpm
SO texture/room4.xpm
WE texture/room3.xpm
EA texture/room1.xpm
S  texture/alpaca_w.xpm

C 239,167,47
F 93,60,45

1111111111111111111111111
1212121212121212121212121
1000000000000000000000001
1001212122121200002122121
10011111111111000011111111111111111111111
10012121212121000000000000000000121212121
10000000000000000012121212121200000000001
11111000001121211111111111111100221122111
12221000001121211111111111111100221111111
1222100000000000122211222112220011111
1222100012121000000000000000000000221
1000000000000000012121212121212111111
1212121212121211011111111111111111111
11111111111111110111111111111111111111111
12222222211111110000000000000000000002221
12222222211111110012121212121212111111111
1222222220000000001111111111111112222221
1222222221111111001221212121212112222221
1222222221111111000000000000000000000021
1111111111111111000000000000000000000021
               110111021110111112111N021
               1222122221100221121110021
               1222122221120221121112221
               1111111111111111111111111
