R  1503 1000
NO texture/room2.xpm
SO texture/room4.xpm
WE texture/room3.xpm
EA texture/room1.xpm
S  texture/alpaca_w.xpm

C 239,167,47
F 93,60,45

111111111111111111111111111
111000001201201201201201201
100000200011000200002000001
100000000211200000100021001
10011111111112000111111111111111111111111
10011111111112000000000000000000012121121
10000201100000010121212121212120000000001
11111102001111111111111111111100000111111
100200000011111111111111111111000N1111111
1111002000000002200110000112000011111
1111000011111000000000200000000011111
1200011000000012002000112002112000021111
1100211202001111111111111111111100000201
1200011111111111111111111111111100001111
1111000001100000100000200000000002021
1111000101100200020120002112000011111
1000000102001100111111111111111210001111
1200000100001100111111111111111111000201
1110200101021000011200002002112000000021
1111111111111100011000000000000000020001
             100000020000002110000000021
             100010200110020110011002001
             102010000110000112011200021
             111111111111111111111111111
