R 1000 1000
NO ./ballons.xpm
SO ./ballons.xpm
WE ./ballons.xpm
EA ./ballons.xpm
S  ./ballons.xpm

C 1, 1, 1
F 1, 1, 1


        11111111111111111111111111
        10000000001100000000000011
        10110000011100000020000011
        1000000000110000000W000011
        10110000011100200020000011
        10000000001100000000000011
        10110000011100000020000011
        10010000000000000000000011
1111111110110000011100000000000011
1000000000110000011101111111111111
1111011111111101110000001000111111
111101111111110111010100100011
110000001101010111000000100011
100020000000000011000000100011
100000000000000011010100100011
110000011111010000000111100111
111100011111100011111010000011
   100011   1110101 1011110011111111111
   100011   1000001 1000000000000000001
   100011   1000001 1000001000000000101
   100011   1000001 1000001000000000101
   100011   100000111000011111111111101
   100011   100000000000000010000001001
   100011   100000111000000010000001001
   100011   1000001 1000000000000001111
   111111   1111111 1111111111111111111
